____________
___A___0____
_0_0_____0__
___0___B____
_____0___0__
